#I    #    # M#
#   #     ##  #
#   #   #  #  #
#       #  #  #
#    #    ##  # 
#  #          #
#      #      #
###############