########################################
#                                    I #
#   ####################################
#                                      #
#   ################################   #
#                                      #
####################################   #
#                                      #
#          #############################
#                                      #
####################################   #
# M                                    #
########################################