####################################################################################
#        #   ########      #########      ##############                        #  #
#        #                 #              #            #                        #  #
#        #                 #              #            #                        #  #
#   #  I                                                       ##################  #
#    #   #                                                                    M    #
#     #  #      #          #              #            #                        #  #
#      # #      #          #                                   ##################  #            
#        #      #          #              #            #                        #  #
#        ##     #          #              #            #                        #  # 
###########  #######       #########      ##############                        #  # 
##########   ####################################################################  #
                                                                                   #
##########   #######################################################################